111111
1PC001
1CC001
1000E1
111111
