11111111111111111111111111111
1CE0000000000000C000000000001
1110P000001000001010011000001
10000000001000011000011000111
11111011111111111101111011111
100000000C00C0000000000001001
11111111111111111111111111111
