1111111111111111111111111111111111
1CE1000000000000C00000100000000001
1111000000100111101001100000110101
10000000001000011000011000111111C1
100000000C00C0P00000001001000000C1
100000000C00C000000000000100001101
1111111111111111111111111111111111
