1111111111111111111111111111111
111C001111C00000001010000011P11
1C11100111000000001001000000E11
101000001000100C0000C1000111111
1010001010010000000000100000011
1010010010001000000000010000011
100C000100001010111111000000011
100001000CCCC0000C00000CC000011
100000100C11C000C1C0000C1C00011
100000010CCCC00CCCCC000CC000011
100000010C0000C00000C00C1C00011
100000000C1000C00000C00CC110111
100000000000001C011100000000011
10000000000000110011C1011111011
1C0000000000100C10000001C000011
1111111111111111111111111111111
