1111111111111111111111111111111111
1CE0000000000000C00000100000000001
1110000000100000101001100000110101
100000000010000PP000011000111111C1
100000000C00C0P00000001001000000C1
100000000C00C00000000000010000EE01
1111111111111111111111111111111111
