111111111111111111111111111111
111C001111C00000001010000011P1
1C11100111000000001001000000E1
101000001000100C0000C100011111
101000101001000000000010000001
101001001000100000000001000001
100C00010000101011111100000001
100001000CCCC0000C00000CC00001
100000100C11C000C1C0000C1C0001
100000010CCCC00CCCCC000CC00001
100000010C0000C00000C00C1C0001
100000000C1000C00000C00CC11011
100000000000001C01110000000001
10000000000000110011C101111101
1C0000000000100C10000001C00001
111111111111111111111111111111
