11111111111111111111111111111
1C100000000C00000100000000001
11110100111101001100000110101
1E1001000011000011000111111C1
1110C00C0P00000001001000000C1
1000C00C000000000000100001101
11111111111111111111111111111
