1111111111111
1000000000001
10000111110E1
1111110P000C1
1111111111111
