1111111111111
10010000000C1
1000011111001
100C11E00P001
1111111111111
