1111111111111
10010000000C1
1000011111011
10C111E00P001
1111111111111
