111111111111111111111111111111
1CE0000000000000C0000010000001
111000000010000010100110000011
100000000010000P10000110001111
100000000C00C01000000010010001
100000000C00C00000000000010001
111111111111111111111111111111
